{
  "refpalette": "lostcities:town_interior",
  "xsize": 16,
  "zsize": 16,
  "slices": [
    [
      "                ",
      "                ",
      "                ",
      "                ",
      "                ",
      "                ",
      "                ",
      "                ",
      "                ",
      "                ",
      "                ",
      "                ",
      "                ",
      "                ",
      "                ",
      "                "
    ],
    [
      "                ",
      "                ",
      "                ",
      "            . . ",
      "    |___|       ",
      "    _uuu_   . . ",
      "    _uuu_       ",
      "    _uuu_       ",
      "    _uuu_       ",
      "    _uuu_       ",
      "    _uuu_       ",
      "    _uuu_       ",
      "    _uuu_       ",
      "    |___|       ",
      "                ",
      "                "
    ],
    [
      "                ",
      "                ",
      "                ",
      "            - - ",
      "    i   i       ",
      "            - - ",
      "                ",
      "      .         ",
      "                ",
      "                ",
      "      .         ",
      "                ",
      "                ",
      "    i   i       ",
      "                ",
      "                "
    ],
    [
      "                ",
      "                ",
      "                ",
      "                ",
      "    i   i       ",
      "                ",
      "                ",
      "      -         ",
      "                ",
      "                ",
      "      -         ",
      "                ",
      "                ",
      "    i   i       ",
      "                ",
      "                "
    ],
    [
      "                ",
      "                ",
      "                ",
      "                ",
      "                ",
      "                ",
      "                ",
      "      E         ",
      "                ",
      "                ",
      "      E         ",
      "                ",
      "                ",
      "                ",
      "                ",
      "                "
    ]
  ]
}
